1,1,0,0,0,1,1
1,1,0,7,0,1,1
1,1,0,7,0,1,1
1,1,0,7,0,1,1
1,1,0,0,0,1,1
1,1,8,8,8,1,1
1,1,0,0,0,1,1
1,1,4,0,7,1,1
1,1,0,7,0,1,1
1,1,0,0,8,1,1
1,1,0,0,8,1,1
1,1,0,0,8,1,1
1,1,7,0,0,1,1
1,1,0,7,0,1,1
1,1,8,0,0,1,1
1,1,8,0,4,1,1
1,1,8,0,0,1,1
1,1,0,0,0,1,1
1,1,0,0,0,1,1
1,1,8,8,8,1,1
1,1,0,0,0,1,1
1,1,0,0,0,1,1
1,1,10,10,10,1,1
1,1,0,7,0,1,1
1,1,0,7,0,1,1
1,1,0,0,0,1,1
1,1,8,8,8,1,1
1,1,0,0,0,1,1
1,1,0,0,0,1,1
1,1,0,6,0,1,1
1,1,0,6,0,1,1
1,1,0,6,0,1,1
1,1,0,0,0,1,1
1,1,8,0,0,1,1
1,1,8,0,0,1,1
1,1,8,0,0,1,1
1,1,0,0,0,1,1
1,1,0,4,0,1,1
1,1,0,0,0,1,1
1,1,0,7,0,1,1
1,1,0,7,0,1,1
1,1,0,0,0,1,1
1,1,10,10,10,1,1
1,1,0,0,0,1,1
1,1,0,0,0,1,1
1,1,0,4,4,1,1
1,1,7,0,0,1,1
1,1,0,0,7,1,1
1,1,0,0,7,1,1
1,1,0,0,4,1,1
1,1,0,0,0,1,1
1,1,0,6,6,1,1
1,1,7,9,6,1,1
1,1,0,9,9,1,1
1,1,0,0,0,1,1
1,1,0,0,0,1,1
1,1,8,8,8,1,1
1,1,0,0,0,1,1
1,1,0,0,0,1,1
1,1,4,4,0,1,1
1,1,0,0,0,1,1
1,1,0,0,0,1,1
1,1,0,0,8,1,1
1,1,0,8,8,1,1
1,1,0,0,0,1,1
1,1,0,0,0,1,1
1,1,8,0,0,1,1
1,1,8,8,0,1,1
1,1,0,0,0,1,1
1,1,0,7,0,1,1
1,1,0,7,0,1,1
1,1,0,0,0,1,1
1,1,8,8,8,1,1
1,1,0,0,0,1,1
1,1,0,7,0,1,1
1,1,0,0,0,1,1
1,1,8,8,8,1,1
1,1,8,7,8,1,1
1,1,8,8,8,1,1
1,1,11,11,11,1,1
